1111111111111111111111111111
1E000000C000000C00000C000C01
1010010100100000101001010101
1010010010101010001001010101
1P0000000C00C000000C000000C1
1111111111111111111111111111