111111
10P0C1
100001
100B01
100001
1C0001
100101
101001
10C001
100E01
10B001
111111