11111111111111111111
100000000000C000B001
1B000P000C00000000E1
100000B000000B0C0001
11111111111111111111