1111111111111
10C10001000C1
100001000C001
1P0C0100000E1
1111111111111
1111111111111
