11111111111111111111
100000000000C0000001
10000P000C00000001E1
100000000000000C0011
11111111111111111111
