11111111111111
1E100000C0C001
1010010P0010C1
10000000000001
11111111111111
