1111111111111111111
1000010000C0000B001
1C00E00P00C00000001
1C00000000C0000B001
1C00000000C00000001
1111111111111111111
